NO                         ./textures/1.xpm
EA ./textures/2.xpm
SO                               ./textures/3.xpm
WE ./textures/4.xpm

C 204,255,255
F 15,6,40

1111111111111111111111111111111111111111111111111111
1000000000010000000000000000000000000000000000000001
1000000000000000000000000100000000000000000000000001
10000N0000000000000000000000000000000000001000000001
1111111111111111111111111111111111111111111111111111