NO                         ./textures/1.xpm
EA ./textures/2.xpm
SO                               ./textures/3.xpm
WE ./textures/4.xpm

C 35,19,73
F 15,6,40

          1111111111111111111111111
          1000000000110000000000001
          1011000001110000000000001
          1001000000000000000000001
11101111101100000111000000000000111
100000000011000001110111111111111
11110111111111011100000W10001
11110111111111011101010010001
11000000110101011100000010001
1000000000000001100000010001
10000000000000001101010010001
1100000111010101111101111000111
11110111 1110101 101111010001
11111111 1111111 111111111111