NO               ./textures/1.xpm
EA ./textures/2.xpm
SO                               ./textures/3.xpm
WE textures/4.xpm

F 15,6,40
C 35,19,73

       1111111111111111111111111
       1000000000110000000000001
       1011000001110000000000001
       1001000000000000000000001
111111111011000001110000000000001
100000000011000001110111111111101
11110111111110011100000010001
11110111111111011101010010001
11000000110101011100000010001
100000000000000001100000010001
10000000000000001101010010001
11000001110101011111011110N0111
11110111 1110101 101111010001
11111111 1111111 111111111111

