NO               ./textures/colors/1.xpm
EA ./textures/colors/2.xpm
SO                               ./textures/colors/3.xpm



WE ./textures/colors/4.xpm





C 255,12,73
F 23,6,40





       1111111111111111111111111
       100000000011000001000W001
       10110000011100001 100000111111
       10010000000000000100000001
111111111011000001110000000000011111
10000000001100000111011111111111
11110111111110011100000010001
11110111111111011101010010001
11000000110101011100000010001
10000000000000000011000000101
10000000000000001101010010001
1100000111010101111101111000111
11110111 1110101 101111010001
11111111 1111111 111111111111

